  _    _          _                 _____                                     
 | |  | |        | |               |  __ \                                    
 | |  | |___  ___| | ___  ___ ___  | |  | |_   _ _ __   __ _  ___  ___  _ __  
 | |  | / __|/ _ \ |/ _ \/ __/ __| | |  | | | | | '_ \ / _` |/ _ \/ _ \| '_ \ 
 | |__| \__ \  __/ |  __/\__ \__ \ | |__| | |_| | | | | (_| |  __/ (_) | | | |
  \____/|___/\___|_|\___||___/___/ |_____/ \__,_|_| |_|\__, |\___|\___/|_| |_|
                                                        __/ |                 
                                                       |___/ 